~	〜
.	。
,	、
/	・
s/	・
s.	…
s,	‥
ssh	←
ssn	↓
sse	↑
ssi	→
s-	〜
et	あ
u	い
n	う
ep	え
sh	お
r	か
w	き
h	く
ec	け
x	こ
b	さ
f	し
a	す
si	せ
q	そ
d	た
es	ち
sm	つ
p	て
t	と
v	な
c	に
ea	ぬ
eb	ね
y	の
g	は
sj	ひ
sl	ふ
ez	へ
ev	ほ
sn	ま
ew	み
ex	む
eg	め
se	も
sk	や
sy	ゆ
si	よ
ef	ら
k	り
m	る
er	れ
;	ろ
ed	わ
eq	ゐ
s;	ゑ
j	を
l	ん
-	ー
st	ぁ
eu	ぃ
en	ぅ
sp	ぇ
eh	ぉ
em	っ
ek	ゃ
ey	ゅ
ei	ょ
sd	ゎ
sr	ヵ
sc	ヶ
in	ゔ
ir	が
iw	ぎ
ih	ぐ
ic	げ
ix	ご
ib	ざ
if	じ
ia	ず
iu	ぜ
iq	ぞ
id	だ
is	ぢ
im	づ
ip	で
it	ど
ig	ば
ij	び
il	ぶ
iz	べ
iv	ぼ
sg	ぱ
ej	ぴ
el	ぷ
sz	ぺ
sv	ぽ