~	〜
.	。
,	、
/	・
d/	・
d.	…
d,	‥
ddh	←
ddj	↓
ddk	↑
ddl	→
d-	〜
[	「
]	」
d[	「
d]	」
k[	『
k]	』
kf	あ
i	い
j	う
kr	え
dh	お
s	か
w	き
h	く
kc	け
x	こ
b	さ
e	し
a	す
di	せ
q	そ
g	た
kd	ち
dm	つ
r	て
f	と
v	な
c	に
ka	ぬ
kb	ね
o	の
t	は
dy	ひ
du	ふ
kz	へ
kv	ほ
dj	ま
kw	み
kx	む
kt	め
dk	も
dn	や
do	ゆ
dl	よ
ke	ら
n	り
m	る
ks	れ
p	ろ
kg	わ
kq	ゐ
dp	ゑ
y	を
u	ん
z	ー
df	ぁ
ki	ぃ
kj	ぅ
dr	ぇ
kh	ぉ
km	っ
kn	ゃ
ko	ゅ
kl	ょ
dg	ゎ
ds	ヵ
dc	ヶ
lj	ゔ
ls	が
lw	ぎ
lh	ぐ
lc	げ
lx	ご
lb	ざ
le	じ
la	ず
li	ぜ
lq	ぞ
lg	だ
ld	ぢ
lm	づ
lr	で
lf	ど
lt	ば
ly	び
lu	ぶ
lz	べ
lv	ぼ
dt	ぱ
ky	ぴ
ku	ぷ
dz	ぺ
dv	ぽ