-		～
q		ー
w		ゃ
e		う
r		ゅ
t		ょ
y		ば
u		ざ
i		か
o		ら
p		わ
@		。
[		「
a		あ
s		い
d		え
f		お
g		っ
h		が
j		さ
k		た
l		な
;		ん
:		、
]		」
z		ぁ
x		ぃ
c		ぅ
v		ぇ
b		ぉ
n		だ
m		は
,		ま
.		や
/		ぱ
\		・
かa	か
かs		き
かe		く
かd		け
かf		こ
かw		きゃ
かr		きゅ
かt		きょ
かz		くぁ
かx		くぃ
かc		くぅ
かv		くぇ
かb		くぉ
さa	さ
さs		し
さe		す
さd		せ
さf		そ
さw		しゃ
さr		しゅ
さt		しょ
さx		すぃ
さv		しぇ
たa	た
たs		ち
たe		つ
たd		て
たf		と
たw		ちゃ
たr		ちゅ
たt		ちょ
たz		つぁ
たx		てぃ
たc		とぅ
たv		ちぇ
たb		つぉ
なa	な
なs		に
なe		ぬ
なd		ね
なf		の
なw		にゃ
なr		にゅ
なt		にょ
なz		1
なx		2
なc		3
なv		4
なb		5
はa	は
はs		ひ
はe		ふ
はd		へ
はf		ほ
はw		ひゃ
はr		ひゅ
はt		ひょ
はz		ふぁ
はx		ふぃ
はc		ふゅ
はv		ふぇ
はb		ふぉ
まa	ま
まs		み
まe		む
まd		め
まf		も
まw		みゃ
まr		みゅ
まt		みょ
まz		［
まx		【
まc		（
まv		「
まb		『
やa	や
やe		ゆ
やf		よ
やw		～
やs		？
やd		！
やr		／
やt		%
やz		］
やx		】
やc		）
やv		」
やb		』
らa	ら
らs		り
らe		る
らd		れ
らf		ろ
らw		りゃ
らr		りゅ
らt		りょ
らz		6
らx		7
らc		8
らv		9
らb		0
わa	わ
わs		ゐ
わe		うぃん
わd		ゑ
わf		を
わw		わん
わr		うぇん
わt		うぉん
わz		うぁ
わx		うぃ
わc		ゎ
わv		うぇ
わb		うぉ
がa	が
がs		ぎ
がe		ぐ
がd		げ
がf		ご
がw		ぎゃ
がr		ぎゅ
がt		ぎょ
がz		ぐぁ
がx		ぐぃ
がc		ぐぅ
がv		ぐぇ
がb		ぐぉ
ざa	ざ
ざs		じ
ざe		ず
ざd		ぜ
ざf		ぞ
ざw		じゃ
ざr		じゅ
ざt		じょ
ざx		ずぃ
ざv		じぇ
だa	だ
だs		ぢ
だe		づ
だd		で
だf		ど
だw		ぢゃ
だr		でゅ
だt		ぢょ
だz		づぁ
だx		でぃ
だc		どぅ
だv		ぢぇ
だb		づぉ
ばa	ば
ばs		び
ばe		ぶ
ばd		べ
ばf		ぼ
ばw		びゃ
ばr		びゅ
ばt		びょ
ばz		ゔぁ
ばx		ゔぃ
ばc		ゔ
ばv		ゔぇ
ばb		ゔぉ
ぱa	ぱ
ぱs		ぴ
ぱe		ぷ
ぱd		ぺ
ぱf		ぽ
ぱw		ぴゃ
ぱr		ぴゅ
ぱt		ぴょ
ぱz		ぱん
ぱx		ぴん
ぱc		ぷん
ぱv		ぺん
ぱb		ぽん